11
11
1 1 1 1 1 1 1 1 1 1 1
1 0 0 0 0 1 0 0 0 0 1
1 0 0 0 0 1 0 0 0 0 1
1 0 0 0 0 1 0 0 0 0 1
1 0 0 0 0 1 0 0 0 0 1
1 1 1 0 1 1 1 0 1 1 1
1 0 0 0 0 0 0 0 0 0 1
1 0 0 0 0 0 0 0 0 0 1
1 0 0 0 0 0 0 0 0 0 1
1 0 0 0 0 0 0 0 0 0 1
1 1 1 1 1 1 1 1 1 1 1
BEGIN OBJECTS
1 2 7 0 // Agent 0 at 1,2
1 8 7 1 // Agent 1 at 7,1
4 9 1 0 // Goal at 9, 1
4 1 1 0 // Goal at 9, 1
3 3 5 0 // Door 0 at 3,2
3 7 5 1 // Door 1 at 6,2
2 3 8 0
2 7 8 1
END OBJECTS