11
11
1 1 1 1 1 1 1 1 1 1 1
1 0 0 0 1 0 1 0 0 0 1
1 0 0 0 0 0 1 0 0 0 1
1 0 0 0 1 0 1 0 0 0 1
1 1 1 1 1 0 1 1 0 1 1
1 0 0 0 0 0 0 0 0 0 1
1 1 0 1 1 0 1 1 1 1 1
1 0 0 0 1 0 1 0 0 0 1
1 0 0 0 1 0 0 0 0 0 1
1 0 0 0 1 0 1 0 0 0 1
1 1 1 1 1 1 1 1 1 1 1
BEGIN OBJECTS
1 2 2 0 // Agent 0 at 1,2
1 2 8 1 // Agent 1 at 7,1
3 5 5 1
2 3 3 1
2 3 7 1
2 7 3 1
2 7 7 1
4 1 1 0 // Goal at 9, 1
4 9 1 0 // Goal at 9, 1
4 1 9 0 // Goal at 9, 1
4 9 9 0 // Goal at 9, 1
END OBJECTS