11
11
1 1 1 1 1 1 1 1 1 1 1
1 0 1 0 0 1 0 0 0 0 1
1 0 1 1 0 1 0 0 0 0 1
1 0 0 0 0 1 0 0 0 0 1
1 1 1 0 1 1 1 0 1 1 1
1 0 1 0 1 0 1 0 1 0 1
1 0 0 0 0 0 0 0 1 0 1
1 0 1 1 1 0 0 0 0 0 1
1 0 1 0 1 1 1 1 0 1 1
1 0 1 0 0 0 0 0 0 0 1
1 1 1 1 1 1 1 1 1 1 1
BEGIN OBJECTS
1 2 2 0 // Agent 0 at 1,2
1 2 8 1 // Agent 1 at 7,1
4 9 5 0 // Goal at 9, 1
4 8 2 0 // Goal at 9, 1
3 7 4 2 // Door 2 at 8,4
2 3 8 2 // Door 2 at 8,4
END OBJECTS