11
11
1 1 1 1 1 1 1 1 1 1 1
1 0 0 0 0 1 0 0 0 0 1
1 0 0 0 0 1 0 0 0 0 1
1 0 0 0 0 1 0 0 0 0 1
1 0 0 0 0 1 0 0 0 0 1
1 0 0 0 0 0 0 0 0 0 1
1 0 0 0 0 1 0 0 0 0 1
1 0 0 0 0 1 0 0 0 0 1
1 0 0 0 0 1 0 0 0 0 1
1 0 0 0 0 1 0 0 0 0 1
1 1 1 1 1 1 1 1 1 1 1
BEGIN OBJECTS
1 1 1 0 // Agent 0 at 1,2
1 4 1 1 // Agent 1 at 7,1
3 5 5 0 // Door 0 at 5,5
2 2 7 0 // Button 0 at 2,7
2 8 7 0 // Button 0 at 8,7
4 8 2 0 // Goal 0 at 8,2
END OBJECTS