9
9
1 1 1 1 1 1 1 1 1
1 0 0 0 1 0 0 0 1
1 0 0 0 1 0 0 0 1
1 0 0 0 0 0 0 0 1
1 0 0 0 0 0 0 0 1
1 0 0 0 1 0 0 0 1
1 0 0 0 1 0 0 0 1
1 0 0 0 1 0 0 0 1
1 1 1 1 1 1 1 1 1
BEGIN OBJECTS
1 1 1 0 // Agent at 1,1 id 1
1 3 1 1 // Agent at 3,1 id 2
4 6 2 0 // Goal at 6,2
END OBJECTS
