7
8
1 1 1 1 1 1 1
1 0 0 1 0 0 1
1 0 0 1 0 0 1
1 1 0 1 0 1 1
1 0 0 0 0 0 1
1 0 0 0 0 0 1
1 0 0 0 0 0 1
1 1 1 1 1 1 1
BEGIN OBJECTS
4 1 1 0
4 5 1 1
3 2 3 0
3 4 3 1
2 2 5 0
2 4 5 1
1 1 5 0
1 5 5 1
END OBJECTS